▒▒▒▒▒▒▒▒▒≈≈^▒▒▒▒▒▒▒▒
▒▒▒▒▒▒▒▒≈≈^Δ^▒▒▒@Δ▒▒
▒▒▒▒▒▒▒▒^ΔΔΔΔ^▒▒▒▒▒▓
▒▒▒Δ▒▒▒▒▒&^^^░░ΔΔ▓▓▓
==░░==▒▒▒▒▒▒▒▒▒≈Δ▓▓▓
▒▒▒==&▒▒▒≈#≈≈@▒▒▓▓▒▒
▒▒▒▓▓▒▒▒≈≈▒▒▒▒▒▒▒▒▒▒
▓▒▒▓▒▒≈≈▒▒▒▒▒▒▒▒▒@▓▓
▓▓▓▒▒≈▒▒▒▒ΔΔ▒▒▒▓▓▓▓▓
▓▓▒▒▒≈≈▒▒≈ΔΔΔ░▓▓▓▓▓▓
▓▒▒▒▒▒▒≈≈▒▒Δ▒▒▒▒▓▓▓▓
▒▒▒▒▒@≈≈▒▒▒▒░░░░░░▓▓
▒▒▒▒▒▒#▒▒▒░░░░░░░░░░
░░Δ¥Δ░░≈≈▒░░░░░░░░░░
ΔΔΔΔΔ░░≈≈≈▒░░░░░░░░░

